1111111111111
1001PC0K000C1
10000C1111001
100011E000001
1111111111111