1111111111111
10010C00K00C1
10000C1111001
1P0011E000001
1111111111111
