1111111111111
10010C0K000C1
1K000C1111001
1P0011E000001
1111111111111
